3 13 31
###############################
#--4----/----4-----@----------#
#-------/---------@-----4-----#
#@@/---@@@@---@@@@----@-------#
#--///@----------u@----@------#
#-----@---@@@------@----@-----#
p-----@-4--e-----4-------@---t#
#@@@@@@@@@@@@@@@@@@@@@@@@@///@#
#---@ -------------------@----#
#---@@@@///@@@@@@@@@@@@@-@----#
#---@--------------4---@-@----#
x---/-----4------------@-/4---#
###############################