4 13 31
#p#############################
#>&#8%%%%%%%%%%%%%%%%%%%%%%%%%#
#>&#%%%%%%%%%%%%%7%%%%%%%%%%%%#
#>&#%%%#####################>&#
#>&#%%%#%%%%%%%%%%8%%%%%%%%#>&#
#>&#%%7#%%%%%7%%%%%%%%%7%%%#>&#
#>&#%%%#%8%%%%%%%o%%%%%%%%%#>&#
#>&#%%%%%%%%%%%%%%%%%%%%%%%#>&#
#>&#%%%%%%7%%%%%%%%%%8%%%%%#>&#
#>&#########################>&#
#,,<<<<<<<5<<<<<<<<<<<<<6<<<<<#
#<<<6<<<<<<<<<<<<<5<<<<<<<<<<<#
###############################